F 220 ,100 ,   0




EA ./textures/east_texture.xpm
NO ./textures/north_texture.xpm
SO ./textures/south_texture.xpm
WE ./textures/west_texture.xpm



C 255,30,0


        1111111111111111111111111111
        1000000000110000000000000101
        1011000001110000000000000101
        1001000000000000000000000101
111111111011000001110000000000000101
100000000011000001110111101111111101
111101111111110111000000100001    01
111101111111110111010100100001    01
110000001101010111000000100001    01
100000000000000011000000100001    01
100000000000000011010100100001    01
110000011101010111110111100N0111  01
11110111 1110101 1011110100001    01
11111111 1111111 111111111111     11
