F 220 ,100 ,   0




EA ./textures/east_texture.xpm
NO ./textures/north_texture.xpm
SO ./textures/south_texture.xpm
WE ./textures/west_texture.xpm



C 255,30,0



111
1W1
111
11111111111111111111111111
1111110000001
1111111111111
