F 224, 224, 121




EA ./textures/east_texture.xpm
NO ./textures/north_texture.xpm
SO ./textures/south_texture.xpm
WE ./textures/west_texture.xpm



C 224, 224, 121


1111111111111111111111111111111111111
1111111111111111111111111111111111111
1100000000000000000000000000000000001
1111111111111111111111100000000000001
1111111000000000000000000000000000001
               10                  1
1000000000000000000000000111111111111
1000011111111111111111111111111111111
100000000000000000000W001111111111111
1111111111111111111111111111111111111
