F 224, 224, 121




NO ./textures/north_texture.xpm
SO ./textures/north_texture.xpm
EA ./textures/north_texture.xpm
WE ./textures/north_texture.xpm



C 122, 122, 90

1111111111111111111111111111111111111
1111111111111111111111111111111111111
1100000000000000000000000000000000001
1111111111111111111111100000000000001
1111111000000000000000000000000000001
               10                  1
1000000000000000000000000111111111111
1E00011111111111111111111111111111111
1000000000000000000000001111111111111
1111111111111111111111111111111111111
