F 220 ,100 ,   0




EA ./textures/east_texture.xpm
NO ./textures/north_texture.xpm
SO ./textures/south_texture.xpm
WE ./textures/west_texture.xpm



C 255,30,0



111
1W1
111
111111
111111


111111
1111
