11111111111111111111111111111111111
10000000000000000000000000000000001
10N00000011111111111111111111111111
10001000000000000000000000000000001
10000000011111111111111111111111111
10000000010000000010000000010000001
10000000010000000010000000010000001
10011110010000000010000000000000001
10000000010000000010000000100000001
11111111111111111111111111111111111
