1111111111
1000000001
10N0000001
1000100001
1000000001
1000000001
1000000001
1001111001
1000000001
1111111111
